a ab abs: from  by   abl
abdo  dere  didi  ditum: put away  withdraw  conceal  cover
abduco  ducere  duxi  ductum: lead away  carry off
abeo  ire  ii  itum: go away
abicio abicere abieci abiectum: throw down
abrumpo  rumpere  rupi  ruptum: break off  sever
absum abesse afui: be away  absent
absumo  sumere  sumpsi  sumptum: take away  use up  consume  waste
accendo  cendere  cendi  censum: kindle  set afire  make hotter  intensify  aggravate
accipio  cipere  cepi  ceptum: receive
Accius  ii m : Accius
accumbo  cumbere  cubui  cubitum: lie down  recline at dinner
acer acris acre: sharp  piercing
acer  cris n : maple tree
acervus  i m : heap  pile
Achilles  is m : Achilles
acus  us m : hairpin
acutus  a  um: sharp  piercing
ad: to  up to  towards   acc
adaperio  aperire  aperui  apertum: open fully
addo  dere  didi  ditum: give to
adedo  edere  edi  esum: consume
adeo  ire  ii  itum: go to
adfecto  are: strive after  grasp at
adimo  imere  emi  emptum: remove
aditus  us m : entrance  approach
adiungo  iungere  iunxi  iunctum: join to  connect  yoke  harness
adiuvo  iuvare  iuvi  iutum: help  assist
admitto  mittere  misi  missum: send in  let in  allow
admoveo  movere  movi  motum: move to  apply to   mil   move up  into position
adsuetus  a  um: usual  customary
adsum adesse affui: be present
adulter  eri m : adulterer
advenio  ire  veni  ventum: come to  arrive at
adversus  um:  adv  and prep   facing  opposite  against  opposed  to
aedes  is f : building   pl   house
aeger aegra aegrum: sick   adv   with difficulty
Aeneas  ae m : Aeneas
Aeneius  a  um: of Aeneas
aequus  a  um: equal
aer aeris m : air
aes aeris n : copper  money  bronze   military  pay  price
Aesonius  a  um: of or descended from Aeson
aestus  us m : tide  heat
aetas  tatis f : age  time of life
aevum  i n : eternity  lifetime  age
affero afferre attuli allatum: bring to
ager agri m : field
agilis  e: light  agile
agmen  minis n : line of march
ago agere egi actum: drive  do  act
aio: say  affirm  say yes  ut aiunt  as they say
Ajax  acis m : Ajax  a Greek hero
albus  a  um: white
Alcinous  i m : Alcinous  king of the Phaecians
ales  itis m  f : large bird  bird of prey  rooster
aliqui  qua  quod: some  any  aliquis aliqua aliquid: someone
alter altera alterum: other of two
altus  a  um: high  lofty  deep
amator  oris m : lover
ambiguus  a  um: uncertain  ambiguous
ambitiosus  a  um: ambitious  eager
ambo  ae  o: both
amens   ntis: out of one s mind  insane  distracted  frantic
amicus  a  um: friendly   as subst   friend
amnis  is m : river  torrent
amo  are: love  amans  ntis m  f : lover
amor  oris m : love  lover
Amymone  es f : Amymone  one of the fifty daughters of Danaus
an: or  in questions   utrum   an: whether   or
ancilla  ae f : female slave
Andromache  es f : Andromache  wife of Hector
anilis  e: old woman
animosus  a  um: bold  spirited
animus  i m : spirit  mind
annus  i m : year
annuus  a  um: of the year  yearly
ante: before  in front of  adv  and prep    acc
antequam: before
antiquus  a  um: ancient  old time  former
anulus  i m : ring
anus  us f : old woman  hag  sorceress
Aonius  a  um: of Aonia  Boeotian
apertus  a  um: open  exposed  free
apis  is f : bee
Apollo  inis m : Apollo
appono  ponere  posui  positum: place near  appoint
apto  are: fit to  adapt to
aptus  a  um: fit  suitable
aqua  ae f : water
aquila  ae f : eagle
aranea  ae f : spider s web  spider
aratrum  i n: plough
Aratus  i m : Aratus
arbor arboris f : tree
arca  ae f : chest  money box
arcanus  a  um: secret  mysterious  hidden
arcus arcus m : bow  arch  arc
ardeo ardere arsi arsum: blaze  glow  be eager
arduus  a  um: towering  lofty
Argeus  a  um: Argive  of Argos
Argi  orum m : Argos  a city in the Peloponnese
arguo arguere argui argutum: accuse  charge  reveal  prove
aries  etis m : ram
arma  orum n  pl : arms  weapons
armilla  ae f : bracelet
armo  are: equip  arm
ars artis f : skill
artus  us m : joint  limb
arvum  i n : ploughed land  field
Ascraeus  a  um: belonging to Ascra
asper  era  erum: rough  harsh  wild  uncultivated
aspicio  ere  spexi  spectum: look to or at  behold
assiduus  a  um: continual  constant
asto  stare  stiti: stand by  stand still
at: but  but yet
atavus  i m: grandfather
ater  tra  trum: dark  black
atque: and in addition  and also  and   after comparatives  than  simul atque  as soon as    ac
Atrax  acis m : Atrax
Atrides  ae m : son of Atreus  Agamemnon
atrium  i n : atrium
attenuo  are: make thin  weaken
Atticus  i m : Atticus
auctor  oris m : originator  founder
audeo audere ausus sum: dare  be eager
audio  ire  ivi  ii  itum: hear  listen to
augeo augere auxi auctum: increase
aura  ae f : breeze
auratus  a  um: golden
aureus  a  um: golden  splendid
aurifer  era  erum: gold bearing
auris  is f : ear
Aurora  ae f : Aurora
aurum  i n : gold
auspicium  i n : omen  sign
aut: or
avarus  a  um: greedy  miserly
aveho  vehere  vehexi  vectum: carry off  bear away
avis  is f : bird
avus  i m : grandfather  forefather
axis  is m : axle  chariot
B
Bacche  ae f : a Bacchante
Bacchus  i m : Bacchus
barbarus  a  um: foreign  strange  savage
Battiades  ae m : son of Battus  the founder of Cyrene
beatus  a  um: happy  blessed  prosperous  fortunate
bellum  i n : war
bellus  a  um: pretty
bene: well
benignus  a  um: kind  generous
bibo bibere bibi: drink
bidens  ntis: mattock  hoe
blandior  iri  itus sum: flatter
blanditia  ae f : flattery  endearment  often pl  with sg  meaning
blandus  a  um: flattering  charming  pleasant  attractive
bonus  a  um: good
Boreas  ae m : the god of the North Wind
bos bovis m : ox  gen  pl  boum
bracchium  i n : the forearm  elbow to hand   arm
Briseis  idos f : Briseis  daughter of Breses
bubo  onis m : owl
C
cado cadere cecidi casum: fall  be killed
caecus  a  um: blind  unseeing  dark  obscure
caedes  is f : killing  slaughter
caedo caedere cecidi caesum: strike  kill  cut down  quarry  stone
caelum  i n : sky  heavens
Caesar  aris m : Caesar
callidus  a  um: clever  crafty  cunning
campus  i m : plain  field
candidus  a  um: white  fair
canesco  ere: become white or hoary  become old
canis  is m  f : dog
cano canere cecini cantum: sing
canto  are: sing
capillus  i m : hair
capio capere cepi captum: seize
captivus  a  um: captured  captive
capto  are: woo  court
caput capitis n : head
carcer  eris m : prison
cardo  inis m : hinge
careo  ere  ui  itum: lack    abl
carina  ae f : keel  ship
cariosus  a  um: decayed  rotten
carmen  inis n : song
carnifex  icis m : executioner
carpo carpere carpsi carptum: pluck  harvest  despoil  fleece
carus  a  um: dear
Cassandra  ae f : Cassandra  a daughter of Priam
Castalius  a  um: Castalian
castigatus  a  um: checked  restrained
castrum  i n : fortress  regularly plural  castra  camp
castus  a  um: pure  spotless  chaste
casus  us m : a fall  chance  accident
catena  ae f : chain  fetter
caterva  ae f : crowd  troop
causa  ae f : cause  reason  causa    preceding gen    for the sake of
causor  ari: plead  pretend  blame
cautus  a  um: cautious  careful  prudent
caveo cavere cavi cautum: be on guard  beware
cedo cedere cessi cessum: go  move  yield
cedrus  i f : cedar
celebro  are: frequent  throng  crowd
celer  is  e: swift
celo  are: hide  conceal  cover  keep in the dark  deceive
cena  ae f : dinner
census  us m : census  wealth
centum: one hundred
Cephalus  i m : Cephalus
cera  ae f : wax portrait bust
Ceres  eris f : Ceres
certus  a  um: sure  fixed
cesso  are: cease  leave off
ceterus  a  um: the others  the rest
cibus  i m : food
cicuta  ae f : hemlock
cingo cingere cinxi cinctum: encircle  surround  gird
circa: around  adv  and prep   acc
circum: around  adv  and prep    acc
citus  a  um: swift  cito  swiftly
clam:  adv   secretly
clamo  are: shout  call
claudo claudere clausi clausum: close  shut
claustrum  i n : bolt  bar
clipeus  i m : round shield
clivosus  a  um: steep  hilly
coepi coepisse coeptum: begin
cognatus  a  um: related by birth
cognitor  oris m : attorney  learned counsel
cognosco  gnoscere  gnovi  gnitum: learn  understand
cogo cogere coegi coactum: drive together  compel
cohaereo  haerere  haesi  haesum: cling to  adhere to
colligo  ere  legi  lectum: gather together  collect
collum  i n : neck
colo colere colui cultum: cultivate  tend  worship
color  oris m : color
coloratus  a  um: colored
columba  ae f : pigeon  dove
coma  ae f : hair  tresses
comes comitis m  f : companion  comrade  attendant  follower
comito  are: accompany  follow
comitor  ari: accompany  follow
commendo  are: commit  commend  recommend
committo  mittere  misi  missum: join  entrust to    dat    perform  do
commodo  are: adapt  accommodate  lend  provide
commodum  i n : advantage  benefit   pl   assets
como comere compsi comptum: make beautiful  adorn  dress  arrange  comb
comparo  are: get ready  provide  compare
complector  plecti  plexus sum: embrace  clasp
complexus  us m : embrace
compono  ponere posui positum: build  construct  arrange
comprimo  primere  pressi  pressum: compress  embrace
concilio  are: advise
concito  are: stir up  excite
concutio  cutere  cussi  cussum: shake  strike  shatter
condo  dere  didi  ditum: build  found  store up  hide  conceal
conduco  ducere  duxi  ductum: lead together  unite  hire  bribe
conductor  oris m : contractor
confero conferre contuli collatum: collect  bring to
confiteor confiteri confessus sum: admit  a fact   confess  a crime   reveal  disclose
congero  gerere  gessi  gestum: gather together  collect  pile up
coniunx coniugis m  f : spouse  husband  wife
conscius  a  um: having common knowledge with another  conspiratorial  conspiring  aware
conserva  ae f : fellow slave  female
consilium  i n : plan  council  group of advisors
consonus  a  um: harmonious
conspicio  spicere  spexi  spectum: notice  attract attention  catch the eye of
consto  stare  stiti: agree  constat  it is established that    acc  and infin
consuetus  a  um: accustomed  usual
consultus  i m : jurist  consult  lawyer
consumo  sumere  sumpsi  sumptum: to use up  consume
contineo  tinere  tinui  tentum: contain  restrain
contingo  tingere  tigi  tactum: touch  border on  happen  come to pass
continuo:  adv   forthwith  immediately
contrarius  a  um: opposite  opposed
contundo  tundere  tudi  tusum: crush  bruise  break
convenio  venire  veni  ventum: assemble  meet  agree
convicium  i n : clamor  uproar  insulting talk  abuse  mockery
convinco  vincere  vici  victum: overcome  prove  convict
conviva  ae m : guest  table companion
cor cordis n : heart  cordi est  it is pleasing to    dat
Corinna  ae f : Corinna
corneus  a  um: made of horn
cornu  us n : horn
corona  ae f : garland  crown
corpus corporis n : body
Corsicus  a  um: Corsican
cortex  icis m : bark  shell
cothurnus  i m : high boot  buskin
cras: tomorrow
credibilis  e: believable  credible
credo credere credidi creditum: believe
crepusculum  i n : evening  twilight
cresco crescere crevi cretum: grow  increase
Cressa  ae f : Cretan woman
crimen  inis n : verdict  accusation
crinis  is m : lock of hair   pl  or collective sg   hair
crudelis  e: cruel  merciless
crus  uris n : shin  leg
crux  ucis f : a cross
cubo cubare cubui cubitum: lie down  recline
culpa  ae f : guilt  fault  blame
cultus  a  um: elegant  polished  sophisticated  cultivated
cum: with  prep    abl    when  since  although  conj   subj
Cupido  inis m : Cupid
cupio  ere  ivi  itum: desire
cur: why
cura  ae f : care  concern
curro currere cucurri cursum: run
currus  us m : chariot
cuspis  idis f : sharp point  tip  esp  of a spear
custos custodis m : guardian
Cytherea  ae f : Venus
D
damno  are: condemn
damnum  i n : damage  injury
de: down from  about  concerning    abl
debeo debere debui debitum: owe  be obliged
decens decentis: becoming  seemly  attractive
decet decere decuit: it is right  proper  fitting   acc   infin
decipio  cipere  cepi  ceptum: catch  cheat  deceive
dedecet  ere  uit: be unsuitable for or unbecoming to   acc
dedico  are: dedicate  consecrate
dedignor  ari: refuse scornfully
deduco  ducere  duxi  ductum: launch  lead away
defendo  fendere  fendi  fensum: defend  ward off
deficio  ficere  feci  fectum: fail  give out  revolt from
defungor  fungi  functus sum: perform  discharge  finish  die
deicio  icere  ieci  iectum: cast down
demens  ntis: out of one s mind  insane  senseless
demo demere dempsi demptum: take away  subtract
denique: finally
dens  ntis m : tooth
densus  a  um: thick  dense  frequent
depereo  perire  perii: destroy completely
depre he ndo  pre he ndere  pre he ndi  pre he nsum: catch  seize  trap
derigo  rigere  rexi  rectum: set straight  direct  guide
deripio  ripere  ripui  reptum: snatch away  tear down
desero  serere  serui  sertum: desert  abandon  leave
deservio  servire: serve  be devoted to   dat
desidia  ae f : idleness  inactivity
desidiosus  a  um: slothful  idle  lazy
desino  sinere  sii  situm: leave off  cease
desisto  sistere  stiti: stand away  withdraw  desist
despicio  spicere  spexi  spectum: look down on  be contemptuous of
desultor  oris m : leaper  a circus rider who leaps from horse to horse
desum  esse  fui: be lacking
detracto  are: decline  refuse
detraho  trahere  traxi  tractum: strip off  remove
deus  i m   dea  ae f : god  goddess
devoveo  vovere  vovi  votum: devote  consecrate  curse  execrate
dexter  tra  trum: right  dextera  ae f   right hand
dico dicere dixi dictum: say  causam dicere  plead a case  diem dicere  appoint a day
diduco  ducere  duxi  ductum: draw apart  separate
dies diei m  f : day
difficilis  e: not easy  hard  difficult
digero  gerere  gessi  gestum: separate  spread
digitus  i m : finder  toe
dignus  a  um: worthy
diligo  ligere  lexi  lectum: choose  cherish  love
dimitto  mittere  misi  missum: send away
Dione  es f : Dione  the mother of Aphrodite  often used for Aphrodite  Venus herself
dipsas  adis f : Dipsas  a kind of serpent whose bite causes violent thirst
dirus  a  um: fearful  dire
discedo  ere  cessi  cessum: go away  depart
discinctus  a  um: wearing a tunic without a belt  wearing loose clothes  easygoing  undisciplined
disco  ere didici: learn
disertus  a  um: eloquent  expressive
dispendium  i n : loss
dispono  ponere  posui  positum: arrange  put in place   mil   to post  station
distraho  trahere  traxi  tractum: pull apart  tear to pieces
diu: for a long time
dives divitis: rich  poet  dis  ditis
divido  ere divisi divisum: divide  separate
dividuus  a  um: divided
do dare dedi datum: give
doceo  ere  ui doctum: teach
docilis  e: teachable  responsive  to styling
doleo  ere dolui dolitum: feel pain or grief  grieve
dolor  oris m : pain  grief
dominus  i m   domina  ae f : household master  lord  mistress
domo domare domui domitum: subdue  tame  conquer
domus  us f : house  home
donec: until
dono  are: present with a gift   acc  of person and abl  of thing
dos dotis f : gift  endowment  dowry
dubito  are: hesitate  doubt
dubius  a  um: doubtful  sine dubio  without a doubt  certainly
duco ducere duxi ductum: lead  uxorem ducere  marry
dulcis  e: sweet
dum: while   indic    until   subj    provided that   subj
dummodo:  conj   provided that  if only  as long as
duo duae duo: two
duplex  icis: double  folded  deceitful  duplicitous
duplico  are: fold over  double
duro  are: last  endure  harden
durus  a  um: hard  tough  harsh
dux ducis m  f : leader  general
E
ecce: behold
edax  acis: voracious  greedy
edisco  discere  didici: learn thoroughly  study
edo edere edidi editum: put forth  state  explain  publish
efficio  ficere  feci  fectum: bring about  complete  render   ut  subj
effundo  fundere  fudi  fusum: pour out
ego mei mihi me: I  me
eloquium  i n : eloquence
emo emere emi emptum: buy  purchase
emodulor  ari: measure out  put into meter
en: lo  behold
Ennius  ii m : Ennius
eo ire ii ivi itum: go
Eous  a  um: of the east  of the dawn
ephemeris  idis f : day book  account book
epulae  arum f  pl : banquet  dinner party
equa  ae f : mare
eques equitis m : horseman  knight
equus  i m : horse
ergo: therefore
erro  are: go astray  wander
error  oris m : error  mistake
erubesco  rubescere  rubui: grow red  blush
erudio  rudire  rudii  ruditum: to instruct  train  free from roughness
et: and
etiam: also  even
Eurotas  ae m : the Eurotas river  the river of Sparta
Eurus  i m : Southwest wind
eventus  us m : consequence  outcome  event  occurrence
evoco  are: call out  summon
ex e: out of  from   abl
exanimis  e: scared stiff  frightened out of one s wits
excipio  cipere  cepi  ceptum: take out
excito  are: wake  rouse
excludo  cludere  clusi  clusum: shut out
excubiae  arum f  pl : the keeping of a watch  a watch
excutio  cutere  cussi  cussum: shake out  throw off
exemplum  i n : example  sample  copy
exeo  ire  ii  itum: go forth
exerceo  ercere  ercui  ercitum: train  exercise  carry on
exigo  igere  egi  actum: drive out  collect
exiguus  a  um: small  slight
eximo  imere  emi  emptum: take out  remove
exitium  i n : going out  destruction  death
experiens  ntis: active  enterprising
externus  a  um: external  outside  foreign
extero  terere  trivi  tritum: rub out  wear away
exterritus  a  um: badly frightened
extremus  a  um: farthest  situated at the end or tip  extreme
exulto  are: exult  rejoice  triumph
F
fabrilis  e: skillfully made
fabula  ae f : account  tale  story
facio facere feci factum: do  make
fallax  acis: deceitful  treacherous  false
fallo fallere fefelli falsum: deceive
falsus  a  um: deceptive  false
falx  cis f : scythe  sickle
fama  ae f : rumor  fame
fateor fateri fassus sum: admit  confess  profess  declare  assent  say yes
fatum  i n : fate  death
felix  icis: lucky
femina  ae f : woman
femineus  a  um: feminine
femur  oris n : thigh
fenestra  ae f : window
fere: almost
fero ferre tuli latum: bear  carry  endure
ferox  ocis: fierce  savage  ferocious
ferreus  a  um: made of iron  hard hearted  cruel
ferrum  i n : iron  iron weapon or implement
ferus  a  um: wild  fierce  fera  ae f   wild animal
fervidus  a  um: intensely hot  blazing
fides  ei f : trust  faith
fidus  a  um: faithful  true
figura  ae f : form  figure
filia  ae f   filius  i m : daughter  son
filum  i n : thread  string
findo findere fidi fissum: split apart
fingo fingere finxi fictum: shape  invent
finio  ire: limit  enclose  end  finish
finis  is m : end  boundary
fio fieri factus sum: become  happen  be done
flagito  are: ask for repeatedly
flamen  inis n : gust  blast  of wind
flamma  ae f : flame  fire
flavens  ntis: golden  yellow
flavus  a  um: golden  fair haired  blonde
fleo flere flevi fletum: weep
flexus  us m : curl  wave  the act of bending or curling
flos floris m : flower  bloom
flumen  inis n : stream  river
flumineus  a  um: of a river
fluo fluere fluxi fluxum: flow  stream  pour
foras: outside  out of doors
fore   futurum esse
foris foris f : door
forma  ae f : shape  beauty
formido  are: fear  dread
formosus  a  um: shapely  beautiful
fors fortis f : chance
forsitan: perhaps  perchance
forte: by chance
fortis  e: brave
fortuna  ae f : fortune
forum  i n : market place  forum
foveo fovere fovi fotum: warm  caress
frango frangere fregi fractum: break  shatter
fraudo  are: cheat of  deprive of
frenum  i n: bridle  reins
fretum  i n : strait   pl   sea
frigidus  a  um: cold
frigus  oris n : cold  coldness
frons frontis f : forehead  brow  front
frux  ugis f : crops  fruits  grain
fugio fugere fugi fugitum: flee  escape
fulcio fulcire fulsi fultum: strengthen  fortify  reinforce
fulgeo fulgere fulsi: shine brightly  flash
fulmen  inis n : thunderbolt  threat of destruction
fulmino  are: flash like lightning
funebris  e: funereal
furor  oris m : rage  fury
furtim:  adv   stealthily  secretly
furtivus  a  um: secret  furtive
G
galea  ae f : helmet
Gallus  i: Gallus
Gangetis  idis: of the Ganges  Indian
garrulus  a  um: talkative  chatty  babbling
gaudeo gaudere gavisus sum: rejoice
geminus  a  um: twin  double
gemma  ae f : jewel  gem
gena  ae f : cheek
genitor  oris m : father
gens gentis f : family  clan
genu  us n : knee
Germania  ae f : Germany
gero gerere gessi gestum: bear  manage  bellum gerere  wage war
glomero  are: form into a ball  mass together
gracilis  e: slender  thin
gramen  inis n : herbs  especially magical ones
grandis  e: great  large
graphium  i n : stilus
gratia  ae f : favor  influence  gratitude
gratus  a  um: pleasant  grateful
gravis  e: heavy  serious
gremium  i n : lap  bosom
grex  egis m : herd  flock
guttur  uris n : windpipe  throat
gypsatus  a  um: whitened with gypsum
H
habeo habere habui habitum: have  hold
habilis  e: suited
Haemonius  a  um: Haemonian  Thessalian
haereo haerere haesi haesitum: stick  adhere
harundo  inis f : reed
Hector  oris m : Hector
Heliconius  a  um: of Helicon
herba  ae f : herb
here:  adv   yesterday
Hesperius  a  um: of the west  western
heu: alas
hic haec hoc: this  these
hic: here  hinc  from here  huc: to this place
hiems hiemis f : winter
hodie: today
Homerus  i m : Homer
homo hominis m : human being
honor  oris m : honor  glory  office  post  compliment
hora  ae f : hour
hortor hortari hortatus sum: urge strongly  advise  exhort
hostis  is m  f : stranger  enemy
humus  i f : earth
I
iacio iacere ieci iactum: throw  hurl
iacto  are: throw  cast
iactura  ae f : loss  of stature prestige
iam: now  already
ianitor  oris m : door keeper
ianua  ae f : door  entrance
ibi: there
icio icere ici ictum: strike
Ida  ae f : Mount Ida
Ide  es f : Mount Ida
idem eadem idem: the same
ignavus  a  um: lazy  idle
ignis  is m : fire
ille illa illud: that
imbellis  e: unwarlike  peaceful
imber  ris m : rain  shower
immemor  oris: unmindful  forgetful
immitis  e: hard  harsh  cruel
immundus  a  um: unclean  foul
impello  ere impuli impulsum: strike or beat against  push
imperium  i n : command  power
impius  a  um: impious  wicked
impono  ere  posui  positum: put in  put on  impose  levy upon
imprimo  primere  pressi  pressum: apply with pressure  press onto  imprint
improbus  a  um: inferior  bad  shameless
in: in  on   abl    into  onto   acc
inanis  e: empty  void  foolish  trifling
inauratus  a  um: gilt
incertus  a  um: disarrayed  errant  wayward
inclamo  are: shout abuse at   dat
includo  cludere  clusi clusum: shut in  confine
incurvus  a  um: bent  curved
inde: from there  from then
indignus  a  um: unworthy  beneath one s dignity  shameful
inemptus  a  um: un bought
ineptus  a  um: foolish
inermis  e: unarmed  defenseless
iners  tis: crude  lacking skill  lazy  idle
infamis  e: notorious  disreputable
infelix  icis: ill fated
inferus  a  um: low  inferior  lower  infimus or imus  lowest
infestus  a  um: hostile  savage
infirmus  a  um: weak  feeble
ingeniosus  a  um: talented  naturally clever
ingenium  i n : disposition  ability  talent
ingenuus  a  um: native  natural  indigenous  tender  delicate
ingratus  a  um: unpleasant  disagreeable
inicio  icere  ieci  iectum: cast into  throw over
innumerus  a  um: countless
inoffensus  a  um:  esp  of feet  not striking against an obstacle  unhindered
inops  pis: without means  poor  destitute
insanus  a  um: mad  insane  senseless
insignis  e: distinguished  remarkable  notable
instar n : the equivalent  just like   gen
instruo  struere  struxi  structum: equip  furnish  prepare  provide
insum  esse  fui: be in or on  be present
inter: between  among  during   acc
intono  tonare  tonui: thunder forth
inutilis  e: useless  unserviceable
invado  vadere  vasi  vasum: attack  assault  fall upon
invenio  venire  veni  ventum: find  discover
invidiosus  a  um: envious  hateful
invidus  a  um: envious  jealous
invisus  a  um: unseen  secret  hated
invitus  a  um: unwilling
io: hurrah  oh
ipse ipsa ipsum: him  her  itself
ira irae f : wrath  anger
irascor irasci iratus sum: grow angry  iratus  a  um  angry
is ea id: he  she  it
Isis  dis f : Isis  an Egyptian goddess
iste ista istud: that  that of yours   adv   istic or istuc  over there  istinc  from over there
ita: thus  so
iterum: again
iubeo iubere iussi iussum: bid  order
iucundus  a  um: pleasant  agreeable  delightful
iudex iudicis m : judge  juror
iugosus  a  um: hilly  mountainous
iugum  i n : yoke  ridge  chain of hills
iungo iungere iunxi iunctum: join
Iuppiter Iovis m : Jupiter
iurgium  i n : altercation  quarrel
ius iuris n : right  justice  law
iustus  a  um: right  just  fair
iuvenalis  e: youthful
iuvencus  i m : young bull  bullock
iuvenis  is m : youth
iuvo iuvare iuvi iutum: help  assist  please  delight
L
labellum  i n : lip
labor  oris m : toil  exertion
labor labi lapsus sum: slip and fall  glide  drop  perish
laboro  are: toil  work  be in trouble or distress
lacertus  i m : the arm  esp  the upper arm
lacrima  ae f : tear
lacrimo  are: weep  shed tears
lacrimosus  a  um: tearful
laedo laedere laesi laesum: injure by striking  hurt
laetus  a  um: glad  joyful
Lais  idis or  idos f : Lais  the name of two famous Greek courtesans
lanificus  a  um: wool working  spinning
lanio  are: tear to pieces  mangle  lacerate
lanugo  inis f : soft hair  down
Lar Laris m : Lar  household god
lascivia  ae f : playfulness  wantonness  licentiousness
lasso  are: tire out  wear out
lassus  a  um: tired  weary
latebra  ae f : hiding place  concealment
lateo latere latui: lie hidden  be hidden
latus  eris n : side  flank  physical strength
latus  a  um: broad  wide
laudabilis  e: praiseworthy  laudable
laudo  are: praise
laurus  i f : laurel
laus laudis f : praise  glory
lavo lavare lavi lautum: wash  bathe
laxus  a  um: wide  loose  spacious
lectus  i m : couch  bed
Lede  es f : Leda
lego legere legi lectum: gather  choose  read
lena  ae f : brothel keeper  madam  procuress  go between
lenis  e: gentle  kind  mild
leno  onis m : pimp
lente:  adv   slowly  leisurely
lentus  a  um: yielding  pliant  supple  unbreakable
levis  e: light  trivial
levo  are: lighten  relieve
lex legis f : law
libellus  i m : little book
Liber Liberi m : Bacchus  Dionysus
libo  are: nibble  sip  touch
libum  i n : cake
liceor liceri licitus: bid for
licet licere licuit licitum est: although  even if
licium  i n : thrum  end of a thread  a thread
lignum  i n : wood
limen liminis n : threshold
lingua  ae f : tongue  language
liquidus  a  um: clear  liquid
lis litis f : lawsuit  quarrel
litoreus  a  um: of the seashore
littera  ae f : letter   pl   literature
liveo  ere: be livid  be black and blue with bruises
lividus  a  um: bluish  envious
livor  oris m : envy
loco  are: place  position  set  hire out
locus  i m : place  loca   n  pl   region
longus  a  um: long  far
loquax loquacis: talkative  loquacious
loquor loqui locutus sum: speak  say
lorum  i n : strap   pl   reins  bridle
Lucifer  feri m : Lucifer  the morning star
Lucretius  ii m : Lucretius
lucrosus  a  um: lucrative  profitable
lucrum  i n : profit
luctor  ari: wrestle  struggle  strive
ludo ludere lusi lusum: play  mock
lumen luminis n : light
luna  ae f : moon
luno  are: bend like a half moon
lupa  ae f : she wolf  prostitute
lupati orum n  pl  : jagged bit  for horses
lusus  us m : play  game
lux lucis f : light  of day
Lycoris  idis f : Lycoris
lyra  ae f : lyre
M
madeo  ere: be wet  be damp
madidus  a  um: moist  wet  drunk
Maenalius  a  um: of Mount Maenalus
Maenas  adis f : Maenad  priestess of Bacchus
Maeonides  ae m : Homer
maestus  a  um: sad  sorrowful  depressing
magister magistri m : master  chief
magnificus  a  um: grand  splendid  magnificent
magnus  a  um: great
magus  a  um: magical
male:  adv   badly
malignus  a  um: malignant  wicked  malicious
malus  a  um: bad  evil
mando  are: order  command  bid
mane:  in the  morning
maneo manere mansi mansum: remain
manifestus  a  um: clear  evident  manifest
mano  are: flow
manus  us f : hand  band of men
marceo  ere: wither  droop  be feeble
mare  is n : sea
margo  inis m : rim  border  edge  margin
maritus  i m : husband
Mars Martis m : Mars
mater matris f : mother
materia  ae f : material  subject matter  timber  lumber
materies materiei f : material
maternus  a  um: maternal
medico  are: treat  medicate  with   dye  with
medius  a  um: middle  central
mel mellis n : honey
membrum  i m : limb  member of the body
memini meminisse: remember  recollect
Memnon  onis m : Memnon
memor memoris: mindful  un forgetting
Menandros  dri m : Menander
menda  ae f : fault  defect  blemish
mens mentis f : mind
mensa  ae f : table
mercabilis  e: purchasable
merces mercedis f : price
mereo merere merui meritum: deserve  merit  serve as a soldier
meretrix meretricis f : prostitute
merito:  adv   deservedly  justly
meritum  i n : meritorious action  service
meritus  a  um: deserving  meriting
merum  i n : wine  wine unmixed with water
merx mercis f : commodity
metuo metuere metui metutum: to fear  to dread
metus  us m : fear  dread
meus  a  um: my
miles  itis m : soldier
militia  ae f : military service  warfare
milito  are: to serve as a soldier
mille  pl   milia: thousand
minae  arum f  pl : threats
ministerium  i n : service  ministry
ministra  ae f : servant  attendant
ministro  are: serve  attend to  take care of
minium  i n : cinnabar
minuo minuere minui minutum: make smaller  lessen  diminish
Minerva  ae f : Minerva
miror mirari miratus sum: wonder at  marvel at   acc
misceo miscere miscui mixtum: mix
miser misera miserum: wretched  pitiable
mitis  e: mild  soft  ripe
mitto mittere misi missum: send  let go
moderabilis  e: controllable
modestus  a  um: moderate  respectful  unassuming
modicus  a  um: moderate  limited
modo: just  just now  modo   modo  now   now  at one moment   at another  sometimes   sometimes
modus  i m : measure  manner  kind
molior moliri molitus sum: set in motion  stir  toil  struggle
mollio mollire mollivi mollitum: make pliable  soften  weaken
mollis  e: soft  yielding  gentle
moneo monere monui monitum: warn  advise
monile  is n : necklace
monimentum  monumentum   i n : reminder  example
mons montis m : mountain
monstro  are: show  point out  show  how to    infin
mora  ae f : delay  hindrance
morbus  i m : sickness  disease
morior mori mortuus sum: die
moror morari moratus sum: delay
mors mortis f : death
mortalis  e: liable to death  mortal
mos moris m : custom  habit   pl   character
motus  us m : motion  movement
moveo  ere movi motum: move
mox: soon
mulier  eris f : woman
multus  a  um: much  many  multo  by far
munimen  inis n : protection  defence  fortification
munus muneris n : gift  offering  duty  obligation   pl   gladiatorial show
Musa  ae f : a Muse  one of the goddesses of inspiration of poetry and the arts and sciences
mustum  i n : unfermented grape juice  must
muto  are: change
myrtus  i f : myrtle
N
nam or namque: for  indeed  really
Nape  es f : Nape   woodland glen  in Greek
narro  are: relate  recount
nascor nasci natus sum: be born
Naso  onis m : Naso
natalis  is m : a birthday
nativus  a  um: native  natural
navita  ae m : sailor  mariner
ne: lest  that not
nec or neque: and not  nor  nec   nec  neither   nor
necto nectere nexi nexum: tie  bind  connect  weave
neglego  legere  lexi  lectum: neglect  disregard
nego  are: deny  refuse
nemo: no one  gen  nullius  dat  nulli  abl  nullo or nulla  nullus  a  um
nempe: certainly
nequiquam: to no avail
nervus  i m : muscle  tendon  cord  string
nescio  scire: not know  be ignorant
nescius  a  um: unknowing  ignorant  unaware
neuter  tra  trum: neither
neve or neu: and not  nor  and that not  and lest
nexilis  e: plaited  intertwined
niger nigra nigrum: black
nihil or nil: nothing  not at all
nimbus  i m : rain cloud  cloud burst  downpour
nimis or nimium: excessively
nisi or ni: if not  unless
niteo nitere nitui: shine  sparkle
nix nivis f : snow
nocens  nocentis: guilty
noceo nocere nocui: harm
nocturnus  a  um: by night  nocturnal
nolo nolle nolui: be unwilling
nomen  inis n : name
non: not
nondum: not yet
nonne:  adv   surely
nonnumquam:  adv   sometimes
nos nostrum nostri nobis nos: we
nosco noscere novi notum: learn   in perfect tenses  know
noster nostra nostrum: our
nota  ae f : mark  sign  brand
noto  are: mark  write
Notus  i m : south wind
notus  a  um: well known
novem:  indecl   nine
novus  a  um: new
nox noctis f : night
nubes  is f : cloud
nubilum  i n : darkness  cloud
nubo nubere nupsi nuptum: cover  veil  be married to
nudus  a  um: naked  bare
nullus  a  um: not any  no one
num: interrogative particle implying negative answer
numen  inis n : divine will  deity
numero  are: count  count out as payment
numerus  i m : number  amount  poetic meter
numquam: never
nunc: now
nuper: adv  not long ago  lately
nusquam:  adv   nowhere
nutrix  icis f : nurse
nutus  us m : nod  command
O
o: oh
obicio  icere  ieci  iectum: throw in the way  reproach  charge  accuse
obliquus  a  um: slanting  indirect  covert
oborior  oriri  ortus sum: arise  appear
obsideo  sidere  sedi  sessum: sit down near  blockade  besiege
obsto  stare  stiti  statum: stand before  obstruct  hinder
obsum  esse  fui: be in the way  hinder  be against
obvius  a  um: in the way  meeting
occulo  culere  cului  cultum: conceal
occulte:  adv   without being noticed
oceanus  i m : the ocean
ocellus  i m : a  little  eye
oculus  i m : eye
odi odisse odosum: hate
officium  i n : service  duty
Olympus  i m : Olympus
omen  inis n : omen  augury
omnis  e: all  every  as a whole
onero  are: weigh down  burden
onus oneris n : load  burden
oppositus  a  um: hostile  opposed
ops opis f : assistance  resources
opto  are: choose  select
opus operis n : work
ora orae f : edge  border
orbis  is m : circle  orbis terrarum  world
ordo  inis m : order  rank
Orestes  is or  ae m : Orestes  a Greek hero
orior oriri ortus sum: arise  begin
Orithyia  ae f : Orithyia  a daughter of Erechtheus
ornatrix  icis f : hairdresser  lady s maid
orno  are: decorate  beautify  arrange  hair   equip
oro  are: pray
os ossis n : bone
osculum  i n : kiss
otium  i n : leisure
ovis  is n : sheep
ovum  i n : egg
P
paciscor pacisci pactus sum: negotiate  seek through bargaining
paelex  icis f : a mistress who was a rival to a wife or lover
pagina  ae f : page
palla  ae f : cloak
pallium  i n : coverlet  mantle
pando pandere pandi pansum or passum: spread out  open up  reveal
pandus  a  um: bent  curved  crooked
pango pangere pepigi pactum: fasten  fix  settle for  agree upon  contract for
papilla  ae f : nipple  breast
par paris: equal
paratus  a  um: prepared  ready
parco parcere peperci parsum: spare  be sparing of   dat
parcus  a  um: thrifty  frugal
parens  ntis m  f : parent
parento  are: make memorial offerings for one s parents
Parius  a  um: of Paros
paro  are: prepare  acquire
pars partis f : part
parum: too little
parvus  a  um: small
pasco pascere pavi patum: feed  nourish
pateo patere patui: lie open  extend  be evident or obvious
pater patris m : father  ancestor
paternus  a  um: of a father  paternal  ancestral
patiens  ntis: long suffering  patient  hardy
patienter:  adv   patiently
patior pati passus sum: permit  endure
paucus  a  um: small  few  pauci  ae  a  pl : a little  a few
pauper  eris: poor  lowly
pavidus  a  um: trembling  quaking  fearful
pax pacis f : peace
pecten  inis m : comb
pectus  oris n : chest  breast
pecus  oris n : cattle  sheep beast  animal  herd
pello pellere pepuli pulsum: strike  beat  push  drive
pendo pendere pependi pensum: weigh  hang  suspend  pay
Penelope  es f : Penelope
penitus:  adv   utterly  deeply
pensum  i n : wool
per: through   acc
perago  agere  egi  actum: pass through  chase  complete
peraro  are: incise
percello  cellere  culi  culsum: strike down  overturn  shatter
perdo  dere  didi  ditum: destroy
perennis  e: continual  perpetual
pereo  ire  ii  itum: perish  be lost
perfero  ferre  tuli  latum: carry through  deliver
perfidus  a  um: faithless  treacherous  false
periurium  peiurium   i n : false oath  lie
periuro  peiero   are: swear a false oath
perlego  legere  legi  lectum: read through
perpetior  peti  pessus sum: bear to the end  endure
perpetuus  a  um: unbroken  perpetual
pervigil  ilis: keeping watch all night  awake
pervigilo  are: keep vigil
pes pedis m : foot
peto petere petivi petitum: seek  aim at
pharetra  ae f : quiver
pharetratus  a  um: wearing a quiver
Phoebus  i m : Apollo
Phrygius  a  um: Phrygian  a territory in Asia minor  Trojan
Pieris  idos f : daughter of Pierus  i e  a Muse
pingo pingere pinxi pictum: paint  dye
pinguis  e: lazy  comfortable
pinna  ae f : feather  wing
placeo placere placui placitum: please
planus  a  um: flat  level
plaudo plaudere plausi plausum: clap  applaud  for    dat
plebs plebis f : the common people
plecto  ere  xi  ctum: beat  punish
plenus  a  um: full
pluma  ae f : feather  down
plus pluris: more
poculum  i n : drinking cup  goblet
poena  ae f : penalty  punishment
pollex  icis m : thumb
pompa  ae f : procession  parade
pomum  i n : fruit tree  fruit
pondus  eris n : weight
pono ponere posui positum: put  place  put aside
pontus  i m : the open sea  the deep
populeus  a  um: of the poplar tree
populus  i m : people
porrigo  rigere  rexi  rectum: stretch out  reach  extend
porta  ae f : gate
porto  are: carry a load  bear  carry  convey
posco poscere poposci: demand  claim  inquire into
possideo  sidere  sedi  sessum: have in one s control  possess  hold
possum posse potui: be able
post: after  adv  and prep   acc
postis  is m : doorjamb  door
postmodo:  adv   later  presently
potens potentis: able  powerful
praebeo  ere  ui  itum: furnish  supply  render
praecipio  cipere  cepi  ceptum: anticipate  advise  warn
praecipue:  adv   especially  particularly
praeda  ae f : booty  prey
praedor  ari  atus: plunder  rob
praefero  ferre  tuli  latum: bear before or in front  prefer
praegusto  are: taste before
praemium  i n : bounty  reward
praeripio  ere  ui  eptum: snatch  carry off
praesto  stare  stiti  stitum or  statum: excel  exhibit
praeter: by  along  past  besides  except   acc
praetereo  ire  ii  itum: go by  pass by
precor  ari  atus: pray  invoke
premo premere pressi pressum: press  pursue  overwhelm
prendo  ere prendi prensum: to lay hold of  grasp  snatch
pretium  i n : price  worth  reward  pretium operae  a reward for trouble  something worthwhile
prex precis f : prayers  entreaties
Priameis  idos f : daughter of Priam  Cassandra
primum: at first  firstly
primus  a  um: first
prior prius: earlier  preceding
pro: for  on behalf of  in proportion to   abl
proavus  i m : great grandfather  ancestor
probo  are: approve  prove  convince one  dat   of a thing  acc
procul: at a distance
procumbo  cumbere  cubui  cubitum: to fall forwards  sink down  fall prostrate
proditio  onis f : betrayal  abandonment  of a cause
prodo prodere prodidi proditus: project  thrust forward  bring forth  produce  give birth to
proelium  i n : battle
profiteor  fiteri  fessus sum: declare  claim  acknowledge
proicio  icere ieci  iectum: cast forth  throw out  fling to the ground
promitto  mittere  misi  missum: send forth  offer
propero  are: hasten  speed
propono  ponere  posui  positum: put forth  propose  present
prosequor  sequi  secutus sum: follow  accompany  attend
prostituo  stituere  stitui  stitutum: prostitute  put to an unworthy use
prosto  stare  stiti  stitum: offer oneself for sale
prosum prodesse profui: be of use  do good  help   dat
protego  tegere  texi  tectum: cover  conceal  protect
proterve:  adv   boldly  impudently
protinus: at once  forthwith
provenio  venire  veni  ventum: come forth  come about
proximus: nearest  next  immediately following
pruinosus  a  um: full of frost  frosty
pudicus  a  um: modest  chaste  virtuous
pudor  oris m : sense of shame  modesty  propriety
puella  ae f : girl  girl friend
puer pueri m : boy  slave
pugno  are: fight
pulcher  chra  chrum: beautiful
pulverulentus  a  um: covered with dust  dusty
pupula  ae f : the pupil  of the eye
purpureus  a  um: purple
purus  a  um: clean  pure  innocent
puto  are: think  suppose
Q
qua: where  how
quaero  rere  sivi  situm: seek  inquire
qualis  e: of what kind  what
qualiscumque qualecumque: whatever kind  whatever sort
quam: how    after comparative  than
quamlibet:  adv   however  in whatever degree
quamvis: however you like  although
quando: when   since  si quando  at any time  at some time  if ever
quantum:  adv   how much  how greatly  how much  how greatly  as
much as
quantus  a  um:  interr   how great   rel   of what size  amount  etc
quasi: as if
que: and
queror queri questus sum: complain of  lament
qui quae quod: who  which  what
quia: because
quicumque quaecumque quodcumque: whoever  whatever
quidam quaedam quoddam: a certain one  someone
quidem: certainly  at least
quiesco quiescere quievi quietum: keep quiet  sleep
quin:  adv   indeed  in fact   conj   so that   not   subj
quinque:  indecl   five
Quiris  itis m : the formal term for a Roman citizen
quis quid: who  what  which
quisque quaeque quidque: each one  everyone
quisquis quidquid: whoever  whichever  whatever  anyone  anything
quod: because
quondam: formerly  once
quoque: also  too
quot: how many  as many as  every time
quotiens: how many times
R
rado radere rasi rasum: scratch  inscribe
ramus  i m : branch
rapidus  a  um: swift  tearing
rapina  ae f : robbery  plundering  pillage
rapio rapere rapui raptum: seize  tear away
rarus  a  um: wide apart  loose  thin  rare  seldom
ratio  onis f : method  plan  reason
ratis  is f : ship
raucus  a  um: harsh sounding  noisy
recens  ntis: fresh  new
recingo  cingere  cinxi  cinctum: ungird  loosen
recipio  cipere  cepi  ceptum: take back  receive  se recipere  betake oneself  go back  return
recompono  ponere  posui  positum: put back together  readjust  rearrange
recurvo  are: bend back  curve backwards
reddo  dere  didi  ditum: return  give back
redeo  ire  ii  itum: go back  return
redimio  imire  imii  imitum: encircle  with a garland
reditus  us m : return  revenue
refero referre rettuli relatum: bring back  report
refertus  a  um: crammed  bursting with
refugio  fugere  fugi: flee back  run away
regno  are: be king  rule
regnum  i n : kingdom  kingship
reicio  icere  ieci  iectum: throw back or away  reject with scorn  spurn
relaxo  are: loosen  open
relentesco  ere: slacken  become less ardent
relevo  are: lighten  relieve
religo  are: tie up  bind fast
relinquo  linquere  liqui  lictum: abandon
removeo  movere  movi  motum: move back  withdraw  remove
renovo  are: restore  refresh  renew
reparabilis  e: reparable  recoverable
repello repellere reppuli repulsum: drive back  repel
rependo  pendere  pendi  pensum: make up for  balance
reperio  perire  pperi  pertum: find  find out
repertor  oris m : discoverer  inventor
requiesco   quiescere  quievi  quietum: rest  repose
res rei f : thing
resanesco  sanescere  sanui: be healed
rescribo  scribere  scripsi  scriptum: write back  respond
reseco  secare  secui  sectum: cut  cut back
resido  sidere  sedi: sit down  sink down  shrink
resisto  ere  stiti: stand still  halt  stop short
respicio  ere  spexi  spectum: look back  regard  consider
resurgo  surgere  surrexi  surrectum: rise again  reappear
rete  tis n : net  trap
retineo  tinere  tinui  tentum: hold back  keep
retorqueo  torquere  torsi  tortum: twist back  bend back
reus  i m : defendant
revoco  are: call back  recall
rex regis m : king
Rhesus  i m : Rhesus
rhombus  i m : a wooden object which  when attached to a string and twirled in the air  produced a loud hissing sound
rideo  ere risi risum: laugh  laugh at
rigeo  ere: be stiff  stiffen
rigidus  a  um: hard  rigid
ripa  ae f : bank of a river
ritu:   gen   in the manner of  like
rivalis  is m : rival
robur  oris n : oak
rodo rodere rosi rosum: gnaw  eat away  erode
rogo  are: ask
Roma  ae f : Rome
ros  oris m : dew
rosa  ae f : rose
roscidus  a  um: bedewed  dewy
roseus  a  um: rosy
rota  ae f : wheel
rubeo  ere: redden  blush
rubor  oris m : redness of face  a feeling of shame
ruga  ae f : wrinkle
rugosus  a  um: wrinkled
rusticitas  atis f : lack of sophistication
S
Sabinus  a  um: Sabine
sacer sacra sacrum: holy  sacred
sacrilegus  a  um: guilty of impiety  sacrilegious
saepe: often
saevus  a  um: fierce  raging  wrathful
sagitta  ae f : arrow
Samiramis  idis f : the legendary queen of Assyria
sanctus  a  um: sacred  inviolable
sanguinulentus  a  um: bloodied  blood red
sanguis  inis m : blood
sapio sapere sapivi: be wise  be sensible
satis sat: enough  sufficiently
saucius  a  um: wounded
saxum  i n : rock  cliff  crag
scelus  eris n : crime  sin
Schoeneis  idos f : the daughter of Schoenius  Atalanta
scindo scindere scidi scissum: cut  rend  tear asunder
scio  ire  ivi  ii  itum: know
scribo scribere scripsi scriptum: write
se sese sui sibi: him  her  itself  themselves
secundus  a  um: following  favorable
securus  a  um: free from care  tranquil  careless
sed: but
sedeo sedere sedi sessum: sit
sedulus  a  um: careful  cautious
segnis  e: slow  slothful
seligo  ligere  legi  lectum: choose  select
semiadapertus  a  um: half open
semisupinus  a  um: half supine  half reclining on one s back
semper: always  ever
senecta  ae f : old age
senectus  utis f : old age
senesco senescere senui: grow old  deteriorate
senex  is m : old man  elder  senior  older
senilis  e: of an old man  senile
sentio sentire sensi sensum: perceive  feel  hear  see
separo  are: sever  separate
septemplex  icis: sevenfold
sepulcrum  i n : place of burial  tomb  grave
sequor sequi secutus sum: follow
sera  ae f : bar  bolt
Seres  um m : Chinese
sermo  onis m : conversation  discourse
servitium  i n : slavery  servitude
servo  are: save  watch over
servus  i m : slave
servus  a  um: of slavery  servile
sex: six
si: if
sic: in this manner  thus  sic   ut  in the same way as
siccus  a  um: dry  desiccated
sidus  eris n : star  constellation
signum  i n : sign  standard  mark
sileo silere silui: be still  be silent
silex  icis m : flint  any hard stone
silva  ae f : forest  grove
similis  e: like  similar
Simois  oentis m : a small river near Troy  flowing into the Scamander
simplex  icis: artless  naive  lacking guile
simplicitas  atis f : simplicity  lack of sophistication  ignorance
simulacrum  i n : image  effigy  apparition
simulo  are: pretend  produce  simulate  feign
simultas  atis f : a state of animosity  a feud
sine: without   abl
singuli  ae  a: one each
sino sinere sivi situm: allow  let go
sinuosus  a  um: full of windings  sinuous
sinus  us m : fold of a garment  lap  bay  gulf
sitis  is f : thirst
situs  us m : site  position  neglect  disuse  rot  mold
sobrius  a  um: sober  moderate
socius  a  um: friendly  allied  socius  i m   partner  comrade
sol solis m : sun
soleo  ere  ui  itum: be accustomed
solidus  a  um: dense  firm  solid
sollemnis  e: customary
sollers  rtis: clever  skilled
sollicito  are: associated with trouble  troubling
sollicitus  a  um: troubled
solus  a  um: only  alone
solvo solvere solvi solutum: release  set sail
somnus  i m : sleep  slumber   pl   dreams
sono sonare sonui sonitum: sound  resound
Sophocleus  a  um: Sophoclean  of Sophocles
sopio sopire sopivi ii sopitum: put to sleep  lull to sleep
soporo soporare: lull to sleep
sordes  is f : filth  greed
sordidus  a  um: filthy  foul  tarnished by greed
soror  oris f : sister
sors sortis f : lot  fate  destiny  oracle
spargo spargere sparsi sparsum: scatter
spatiosus  a  um: wide  spacious  large
spectabilis  e: visible  notable  remarkable
specto  are: look at  consider
speculator  oris m : spy  sentinel  look out  one employed to observe
speculum  i n : mirror
spero  are: to hope
spes spei f : hope
spiculum  i n : sharp point  sting  arrow
spissus  a  um: close  dense  thick
splendidus  a  um: shining  clear  brilliant  splendid
spolium  i n : plunder  spoils
spondeo  ere spopondi sponsum: make a solemn promise
sponte:  abl  sg  as adv   naturally  by nature  voluntarily
statio  onis: position
stella  ae f : star
sterno sternere stravi stratum: spread out  strike down  lay low
stillo  are: drip with
stipula  ae f : stubble
sto stare steti statum: stand
stratum  i n : bedding  coverlet   often in pl   bed
strenuus  a  um: brisk  prompt  vigorous
stringo stringere strinxi strictum: unsheathe
strix strigis f : screech owl
studium  i n : eagerness  zeal
suadeo suadere suasi suasum: recommend  advise
sub: under  close to   acc  or abl
subduco  ducere  duxi  ductum: draw up  raise  remove  take away
subeo  ire  ii  itum: go under  endure
subicio  icere  ieci  iectum: throw under  place under  lift
sublimis  e: lofty  elevated
subluceo  lucere: shine faintly  glimmer  gleam
subscribo  scribere  scripsi  scriptum: write under  write beneath
succurro  currere  curri  cursum: run quickly  come to mind
sum esse fui: be  exist
summus  a  um: highest  uppermost  final
sumo sumere sumpsi sumptum: take up
super: over  adv  and prep   acc
superbus  a  um: overbearing  proud  haughty
supercilium  i n : eyebrow
supero  are: overcome  surpass  defeat
superstes  itis: surviving  remaining alive after death
supersum  esse  fui: remain  survive  be superfluous  to
supplex  icis: kneeling  supplicating  suppliant
supprimo  primere  pressi  pressum: hold back  check
supremus  a  um: highest  uppermost  final
surdus  a  um: deaf
surgo surgere surrexi surrectum: rise
surripio  ripere  ripui  reptum: take away secretly  steal
suspendium  i n : act of hanging oneself  a hanging  gallows
suspendo  pendere  pendi  pensum: suspend  hold up  check  keep under control
suspicor  ari: suspect  suppose
sustineo sustinere sustinui: hold up  sustain
suus  a  um: his own  her own  its own
Sygamber  bra  brum: of the Sygambri
T
tabella  ae f : flat board  tablet   pl   writing tablet
tabula  ae f : account book  ledger
taceo  ere  ui  itum: be silent  tacitus  a  um  silent
Tagus  i m : the river Tagus
talis tale: such
tam: so  so much
tamen: nevertheless  still
tamquam: so as  just as
tango tangere tetigi tactum: touch
tantus  a  um: so great  so much
tardus  a  um: slow  sluggish  lingering
Tatius  ii m : Tatius
taurus  i m : bull
tectum  i n : roof  building  house
tego tegere texi tectum: cover  conceal
telum  i n : missile  weapon  spear
temerarius  a  um: accidental  thoughtless  impetuous
temere:  adv   at random  casually
temero  are: violate  desecrate  defile
tempe:  indecl  noun  n  pl   the Vale of Tempe in Thessaly  any pleasant valley
tempero  are: set bounds  control  regulate
templum  i n : consecrated ground  temple
tempto  are: try  test  attack
tempus  oris n : time
tempus  oris n : the side of the forehead  temple
tendo tendere tetendi tentum: stretch  extend  direct  one s steps or course
tenebrae  brarum f  pl : darkness  the shadows
Tenedos  i f : Tenedos  island
teneo  ere  ui tentum: hold  keep
tener  era  erum: tender
tenuis  e: slender  thin
tenuo  are: make thin  make fine
tepidus  a  um: warm  tepid
ter:  adv   three times  thrice
tergum  i n : back  rear  a tergo  from the rear
terra  ae f : land
testificor  ari: give proof of
testis  is m : witness
thalamus  i m : marriage bed  bedchamber
Theseus  ei m : Theseus
Thracius  a  um: Thracian
Threicius  a  um: Thracian
Tibullus  i m : Tibullus
tigris tigris m : tiger
timeo  ere  ui: fear  dread
timidus  a  um: fearful  timid  shy
timor  oris m : fear
tingo tingere tinxi tinctum: wet  moisten  dye  color
Tithonus  i m : Tithonus
Tityrus  i m : one of the shepherds in Virgil s Eclogues and the first word of Eclogue
tollo tollere sustuli sublatum: raise up  destroy
torqueo torquere torsi tortum: twist  wrench  torment  torture
torrens  ntis m : a rushing stream  torrent
torus  i m : bed  couch  cushion
tot: so many
totus  a  um: whole  entire
trabs  is f : beam  tree
tracto  are: draw  drag  haul
trado  dere  didi  ditum: hand over  yield
traho trahere traxi tractum: drag  draw
traicio  icere  ieci  iectum: throw across  pierce  pass through
transeo  ire  ii  itum: go across
tremo tremere tremui: tremble  quake
tres tria: three
tribunal  alis n : tribunal
tribuo tribuere tribui tributum: grant  bestow  award
tristis  e: sad  solemn  grim
triumpho  are: triumph  have a triumph
triumphus  i m : triumph  triumphal procession
trivium  i n :  often pl   a crossroads  gutter
Tros Trois m : Trojan  man of Troy
tu tui tibi te: you  sing
tueor tueri tutus sum: protect  especially in a military sense
tum or tunc: then
tumeo tumere tumui: swell  puff up
tumidus  a  um: swollen  tumid  enraged  violent
tundo tundere tutudi tunsum: to pound  strike
tunica  ae f : tunic
turba  ae f : crowd  uproar
turpis  e: ugly  unsightly  disgraceful
tutus  a  um: safe  protected
tuus  a  um: your
Tydides  ae m : the son of Tydeus  Diomedes
U
ubi: where  when
udus  a  um: wet  damp
ullus  a  um: any  anyone
ultimus  a  um: farthest  final  last  ultimate
ultor  oris m : avenger  punisher
umbra  ae f : shade  shadow
umeo  ere: be wet  moist
umerus  i m : shoulder
umquam: ever
unda  ae f : wave  flowing water  water
undeni  ae  a: eleven each  eleven at a time
unguis  is m : fingernail  claw  talon
unus  a  um: one
urbs urbis f : city
urgeo urgere ursi: press  drive on  urge  insist
urna  ae f : urn  pitcher
uro urere ussi ustum: burn
usque: up to  continuously
usus  us m : use  experience
ut uti: as    indic    so that  with the result that    subj
uterque utraque utrumque: each of two
utilis  e: useful
utor uti usus sum: use  consume  employ    abl
uva  ae f : grape
uxor uxoris f : wife
V
vacca  ae f : cow
vaco vacare: be empty  open  unoccupied
vacuus  a  um: empty
vadimonium  i n : guarantee  contract
valeo valere valui valitum: be strong  excel  be valid  prevail  vale
farewell
valles  is f : vale  valley
vallum  i n : palisade
vanesco  ere: disappear  vanish
vanus  a  um: empty  false  deceitful
vapor  oris m : vapor  steam  heat
vario  are: vary  diversify  adorn with various colors
Varro  onis m : Varro
varus  a  um: crooked  bent  diverse  different
vates  is m : poet  bard
ve: or
veho vehere vexi vectum: carry  vehor vehi vectus sum  travel  ride  carry  bring
vel: or else  or  vel   vel  either   or
velamen  inis n : covering  garment
velo  are: cover  clothe
velum  i n : sail  fabric
vena  ae f : vein
vendo  dere  didi  ditum: sell  vend
venenum  i n : drug  venom  dye
venia  ae f : favor  indulgence  pardon  forgiveness
venio venire veni ventum: come
venter  ris m : stomach  belly
ventilo  are: wave  fan  brandish
ventus  i m : wind
Venus  eris f : Venus
verber  eris n : whip  a beating or blow with a whip
verbosus  a  um: wordy  verbose
verbum  i n : word
vere: truly
verecundus  a  um: bashful  modest  shy
verro verrere verri versum: sweep  sweep over  skim
verso  are: turn  spin  turn back and forth  twist  torment
versus  us m : line of writing  line of verse
vertex  icis m : a whirl  whirlwind  summit  top of the head
verto vertere verti versum: transform
verus  a  um: true
vesanus  a  um: wild  frenzied  insane
vester vestra vestrum: your
vestigium  i n : footstep  footprint  track
vestis  is f : garment  robe  clothing
veto  are vetui vetitum: forbid
vetus veteris: old
vexo  are: attack constantly  harass  vex
via  ae f : way  street
viator  oris m : traveler  wayfarer
vibro  are: vibrate  shake  move to and fro
vicinus  a  um: neighboring  near
vicis  gen   f : repayment of a good turn  requital
victor  oris m : conqueror
victrix  cis: victorious  triumphant
video videre vidi visum: see
vigil  ilis m : sentry  guard
vilis  e: cheap  worthless  contemptible  of inferior rank
vinco vincere vici victum: conquer
vinculum  i n : bond  fetter  tie
vindex  icis m : champion  defender  avenger
vindicta  ae f : vengeance  punishment
vinum  i n : vine  wine
violentus  a  um: violent  savage
violo  are: profane  dishonor  treat with violence  violate
vir viri m : man
virgineus  a  um: maidenly  of a virgin
virgo  inis f : maiden  virgin  girl
viridis  e: green
virus  i n : bodily fluid  secretion
vis f : force   acc   vim   abl   vi   pl   vires  strength  force
viscus  eris n : internal organs  womb
vita  ae f : life
vitis  is f : vine  grapevine
vitium  i n : flaw  fault  crime
vitreus  a  um: glassy
vitricus  i m : stepfather
vittatus  a  um: bound up by a fillet  a strip of fabric worn by women or in religious rituals
vivo vivere vixi victum: live
vivus  a  um: alive  living
vix: scarcely
voco  are: call
volatilis  e: flying  fleeting
volito  are: fly around
volo velle volui: wish  be willing
volo  are: fly
voltur volturis m : vulture
voluptas  atis f : pleasure  enjoyment
volvo volvere volvi volutum: roll  wind  twist round
vos: you  pl     gen   vestrum vestri   dat  abl   vobis   acc   vos
votum  i n : solemn promise  vow  hope
vox vocis f : voice  utterance
vulgus  i n  and m : the common people
vulnus  eris n : wound
vultus  us m : look  expression  face
Z
Zephyrus  i m : a gentle west wind  the western breeze  zephyr
zona  ae f : girdle